+---+---+---+---+---+
| S         |       |
+   +---+   +---+   +
|   |           |   |
+   +---+---+   +   +
|           |       |
+   +---+   +---+---+
|   |   |           |
+   +   +---+---+   +
|           |     E |
+---+---+---+---+---+


