+---+---+---+---+---+
|           |       |
+   +---+   +---+   +
|   | S         |   |
+   +---+---+   +   +
|           |       |
+   +---+   +---+---+
|   | E |           |
+   +   +---+---+   +
|           |       |
+---+---+---+---+---+