+---+---+---+---+---+---+---+---+---+---+
| S         |       |           |       |
+   +---+   +---+   +   +---+   +---+   +
|   |           |   |   |           |   |
+   +---+---+   +   +   +---+---+   +   +
|           |       |                   |
+   +---+   +---+---+   +---+   +---+---+
|   |   |           |   |   |           |
+   +   +---+---+   +   +   +---+---+   +
|           |       |           |       |
+---+   +---+---+---+---+---+---+---+   +
|           |       |           |       |
+   +---+   +---+   +   +---+   +---+   +
|   |           |   |   |           |   |
+   +---+---+   +   +   +---+---+   +   +
|           |                           |
+   +---+   +---+---+   +---+   +---+---+
|   |   |           |   |   |           |
+   +   +---+---+   +   +   +---+---+   +
|           |       |           |     E |
+---+---+---+---+---+---+---+---+---+---+


