+---+---+---+---+
| S     |       |
+---+   +---+   +
|   |           |
+   +---+---+   +
|       |       |
+   +---+   +---+
|             E |
+---+---+---+---+


